***********
*.........*
*....P....*
*.........*
***********